20 10
********************
* * ****** * *T    *
* *        * ****  *
* ***** **** *  *  *
*       *    *  *  *
**** ******* **    *
*S** *       ****  *  
* ** ******* **    *
*               ** * 
********************  